Animales de la granja

Pulsa sobre los animales para saber su nombre.

Click on the animals to know his name.

Abeja - Bee
Gato - Cat
Vaca - Cow
Gallina- Hen
Grillo - Cricket
Perro- Dog
Pato - Duck
Rana - Frog
Cabra - Goat
Caballo - Horse
Cerdo - Pig
Oveja - Sheep`






Las profesiones 
pulsa sobre las profesiones para saber su nombre

click on the professions to know its name

PAscador - fisherman
pintor - painter
maestra -teacher
fotografo - photographer
costurera - dressmaker
informatico - IT woman
carpintero - carpenter
electricista - electrician
pastelero - pastry chef
bombero - fireman
panadero - baker
mecanico -mechanics
zapatero -shoemaker
cartero - postman



El baño
Pulsa sobre los objetos del baño para saber su nombre
Push over the object on the bash so you can learn their name motherfucking nigga

Armario - Wardrobe
Espejo - Mirror
Toalla - Towel
Baño- Toilet
Alfombra - Carpet
Barco- Ship
Pato- Duck
Cepillo de dientes - Toothbrush
Cuadro - Painting



